111111111111111111
1C0100C0000C000001
100001111111111001
1P0011E000000000C1
111111111111111111