1111111111111111111
1C0100C0000C0000001
1100011111111101000
1110110000000001001
1P0011E001111C01C01
1111111111111111111
