111111111111111111
1C0100C0000C000001
110001111111110101
111011100000000101
1P0011E00111C001C1
11101C011101011111
1C001111C001000001
10111C0100011011C1
100111010100001111
100000000101100EC1
111111111111111111
