11111111111111111
10000000P00000001
1E00020000C000001
11111111111111111
