1111111111111111111111111111111
10100000001000000C0000000000001
10P1110C001000000C0000000000001
1000C000001000000C0000000000001
1000C0E0001000000C0000000000001
1000C000001000000C0000000000001
1000C000001000000C0000000000001
1000C000001000000C0000000000001
1000C000001000000C0000000000001
1000C000001000000C0000000000001
1000C000001000000C0000000000001
1000C000001000000C0000000000001
1000C000001000000C0000000000001
1000C000001000000C0000000000001
1000C000001000000C0000000000001
1000C000000000000C0000000000001
1000C000001000000C0000000000001
1000C000001000000C0000000000001
1000C000010100000C0000000000001
1000C000001000000C0000000000001
1000C000001000000C0000000000001
1000C000000000000C0000000000001
1111111111111111111111111111111
