11111111111111111111111
1E000000000000000000001
10000000011111111000001
1P00000001C000000000001
11111111101111111111111
